4
21 21
1   1   1   1   1   1   1   1   1   1   1   1   1   1   1   1   1   1   1   1   1     
1   1   1   1   1   1   1   1   1   1   1   1   1   1   1   1   1   1   1   1   1
1   1   33  25  25  25  25  25  25  25  25  25  25  25  25  25  25  25  36  1   1
1   1   32  13  13  13  13  13  13  13  13  13  13  13  13  13  13  13  31  1   1
1   1   32  13  13  13  13  13  54  54  13  54  54  13  13  13  13  13  31  1   1
1   1   32  13  13  13  13  13  54  13  13  13  54  13  13  13  13  13  31  1   1
1   1   32  13  13  13  13  13  54  13  13  13  54  13  13  13  13  13  31  1   1
1   1   32  13  13  13  13  13  54  54  13  54  54  13  13  13  13  13  31  1   1
1   1   32  13  13  13  13  13  13  54  13  54  13  13  13  13  13  13  31  1   1
1   1   32  13  13  13  13  13  13  13  13  13  13  13  13  13  13  13  31  1   1
1   1   32  13  13  13  13  13  13  13  13  13  13  13  13  13  13  13  31  1   1
1   1   32  13  13  13  13  13  13  13  13  13  13  13  13  13  13  13  31  1   1
1   1   35  37  13  13  13  38  26  26  28  26  26  37  13  13  13  38  34  1   1
1   1   1   32  13  13  13  31  49  50  14  49  50  32  13  13  13  31  1   1   1
1   1   1   32  13  13  13  31  1   1   14  1   1   32  13  13  13  31  1   1   1
1   1   1   32  13  13  13  31  1   18  20  19  1   32  13  13  13  31  1   1   1
1   1   1   35  26  26  26  34  1   14  1   14  1   35  26  26  26  34  1   1   1
1   1   1   1   1   1   1   1   1   14  1   14  1   1   1   1   1   1   1   1   1
1   1   1   1   1   1   1   1   1   17  22  16  1   1   1   1   1   1   1   1   1
1   1   1   1   1   1   1   1   1   1   14  1   1   1   1   1   1   1   1   1   1
1   1   1   1   1   1   1   1   1   1   14  1   1   1   1   1   1   1   1   1   1
   
